Trending Tickers
AI Forecasted Stocks for Woods and Pop Ltd

Symbol	Name	
GOOG	Alphabet Inc.	
DIS	The Walt Disney Company
PACW	PacWest Bancorp
GOOGL	Alphabet Inc.	
HOOD	Robinhood Markets, Inc.	
GT	The Goodyear Tire & Rubber Company	
U	Unity Software Inc.	
TLRY	Tilray Brands, Inc.	
BYND	Beyond Meat, Inc.	
SONO	Sonos, Inc.
APP	AppLovin Corporation	
SBFM	Sunshine Biopharma, Inc.	
BE	Bloom Energy Corporation	
BABA	Alibaba Group Holding Limited	
CRSR	Corsair Gaming, Inc.	
JAGX	Jaguar Health, Inc.	
POLA	Polar Power, Inc.	
TTD	The Trade Desk, Inc.	
ZURA	Zura Bio Limited	
PTON	Peloton Interactive, Inc.	
BBIG	Vinco Ventures, Inc.	
JD	JD.com, Inc.	
PSNY	Polestar Automotive Holding UK PLC	
META	Meta Platforms, Inc.	
IBRX	ImmunityBio, Inc.	
CIX.TO	CI Financial Corp.	
WAL	Western Alliance Bancorporation	
MAXN	Maxeon Solar Technologies, Ltd.	
PFE	Pfizer Inc.	
MANU	Manchester United plc	


